NO  pngs/no.png
SO  pngs/so.png
EA  pngs/ea.png
WE  pngs/we.png
F 91,110,105
C 39,153,245





1111111111111111111111111111111
0000000000110000000000000000001
1111100001110000000000001000001
1001000000000000000000001000001    
1011000001110000000000001000001
1000000000110000011101111000001
1111011111111101110000001000001
1111011111111011101010010000011
1100000011010101110000001000001
1000000000000000110000001000001
10000000000000001101010010S0001
1100000011010100000000000000001
1111011111010100000010100000001
1000000000110000010000001000001
1000000000000001000100001000011
1000000000100001000000000100001
1000000000110100000000000000001
1000000000010000000101000000001
1111111111111111111111111111111